60 48
wwwwwwwwwwwwwwwwwwwwwwwwwwwwwwwwwwwwwwwwwwwwwwwwwwwwwwwwwwww
w     w                      ww                            w                                                                                                                       
w  b  w    h   e   w         ww                            w                                                                                                                        
w     w            w         ww                            w                                                                                                                        
w     w       s    w     p   ww               w            w                                                                                                                       
w  h               w                           w           w                                                                                                                                                                                                                          
w      e      h    w                            w          w                                                                                                                                                                                                                          
w   h              wwww   wwwww                  w         w                                                                                                                                                                                                                          
w              e   whhhhhhhhhww                   w        w                                                                                                                       
w                  whhhhhhhhhww                  w         w                                                                                                                                                                                                                          
w                  whhhhhhhhhww                 w          w                                                                                                                                                                                                                          
wwwwwwwwwwwwww  wwwwwwwwwwwwwwww  wwwwwwwwwwww wwwwwwwwwwwww
wwwwwwwwwwwwww  wwwwwwwwwwwwwwww  wwwwwwwwwww wwwwwwwwwwwwww
w     w                      ww                            w
w     w    h   e   w                                       w
w     w            w                                       w
w     w       e    w         ww                            w
w  h               w         wwwwwwwwwwwwwwwww           www
w      e      h    w         ww                            w
w   h              wwww   wwwww                            w
w              e   whhhhhhhhhww                            w
w                  whhhhhhhhhww                            w
w                  whhhhhhhhhww         wwwwww             w
wwwwwwwwwwwww  wwwwwwwwwwwwwwww        w      w            w
wwwwwwwwwwwww  wwwwwwwwwwwwwwww       w        w           w
w     w                      ww       w        w           w
w     w    h       w         ww       w        w           w
w     w            w                   w      w            w
w     w            w                    ww  ww             w
w  h               w         ww                            w
w           wwh    w         ww                            w
w   h      ww      wwww   wwwww                            w
w         ww       whhhhhhhhhwwwwwwwwwwww     wwwwwwwwwwwwww
w         w        whhhhhhhhh                              w
w        ww        whhhhhhhhhww                            w
wwwwwwwwwwwwww  wwwwwwwwwwwwwww                            w
wwwwwwwwwwwwww  wwwwwwwwwwwwwww                            w
w     w      w               ww                            w
w     w    h w     w         ww                            w
w     w      w     w         ww                            w
w     w      w     w         ww                            w
w  h         w     w                                       w
w            wh    w                                       w
w   h        w     wwww   wwwww                            w
w            w     whhhhhhhhhww                            w
w   wwwwww www     whhhhhhhhhww                            w
w                  whhhhhhhhhww                            w
wwwwwwwwwwwwwwwwwwwwwwwwwwwwwwwwwwwwwwwwwwwwwwwwwwwwwwwwwwww