60 96
wwwwwwwwwwwwwwwwwwwwwwwwwwwwwwwwwwwwwwwwwwwwwwwwwwwwwwwwwwww
w  b  w                      ww                            w
w     w     s      w         ww                            w
w     w            w         ww     z                      w
w     w            w         ww             s w            w
w                  w                           w           w
w        z         w               p            w          w
w                  wwww   wwwww                  w         w
w                  w         ww                   w        w
w                  w    h    ww                  w     S   w
w                  w         ww                 w          w
wwwwwwwwwwwwww  wwwwwwwwwwwwwwww  wwwwwwwwwww  wwwwwwwwwwwww
wwwwwwwwwwwwww  wwwwwwwwwwwwwwww  wwwwwwwwwww wwwwwwwwwwwwww
w     w                      ww                            w
w     w            w                                  z    w
w     w            w                                       w
w     w            w   z     ww                z           w
w            s     w         wwwwwwwwwwwwwwwww           www
w                  w         ww                            w
w    z    z       wwww   wwwww               s             w
w                  w         ww                       w    w
w                  w    h    ww                      ww    w
w                  w         ww         wwwwww      www    w
wwwwwwwwwwwww  wwwwwwwwwwwwwwww        wwwwwwww    wwww    w
wwwwwwwwwwwww  wwwwwwwwwwwwwwww       wwwwwwwwwwwwwwwww    w
w     w               z      ww      wwwwwwwwwwwwwwwwww    w
w     w            w         ww       wwwwwwwwwwwwwwwww    w
w     w            w                   wwwwwwww    wwww    w
w     w         s  w    h               wwwwww      www    w
w        z         w         ww                      ww    w
w           ww     w         ww      z                w    w
w z        ww      wwww   wwwww                            w
w         ww       w         wwwwwwwwwwww     wwwwwwwwwwwwww
w         w        w                                       w
w        ww        w         ww     w    wwww w            w
wwwwwwwwwwwwww  wwwwwwwwwwwwwww     w    w  w w        z   w
wwwwwwwwwwwwww  wwwwwwwwwwwwwww     w    w  w w            wda
w     w      w               ww     w    w  w w            w
w     w      w     w         ww     w    w  w w            w
w     w      w     w         ww     wwww wwww wwww         w
w     w z    w     w  z      ww                            w
w            w     w                                       w
w       s    w     w                z        s             w
w            w     wwww   wwwww                            w
w            w     w   h     ww                      h     w
w   wwwwww www     w         ww                            w
w                  w         ww                            w
wwwwwwwwwwwwwwwwwwwwwwwwww                      wwwwwwwwwwww
wwwwwwwwwwwwwwwwwwwwwwwwww                      wwwwwwwwwwww
w     w                      ww         z                  w
w     w            w         ww                            w
w     w            w         ww                            w
w     w            w         ww               w            w
w          z       w                           w           w
w                  w                            w          w
w                  wwww   wwwww   s     z        w         w
w                  w         ww                   w        w
w      s           w         ww                  w         w
w                  w   h     ww                 w          w
wwwwwwwwwwwwww  wwwwwwwwwwwwwwww  wwwwwwwwwww  wwwwwwwwwwwww
wwwwwwwwwwwwww  wwwwwwwwwwwwwwww  wwwwwwwwwww wwwwwwwwwwwwww
w     w                      ww                            w
w     w            w                                       w
w     w            w                    z                  w
w     w            w         ww                            w
w              z   w         wwwwwwwwwwwwwwwww           www
w                  w         ww                            w
w                  wwww   wwwww                            w
w      z           w         ww                            w
w                  w    h    ww                    z       w
w                  w         ww         wwwwww             w
wwwwwwwwwwwww  wwwwwwwwwwwwwwww        w      w            w
wwwwwwwwwwwww  wwwwwwwwwwwwwwww       w        w           w
w     w                      ww       w        w       s   w
w     w            w         ww       w        w           w
w     w         z  w                   w      w            w
w     w   s        w                    wwwwww             w
w                  w         ww                            w
w           ww     w         ww         z                  w
w          ww      wwww   wwwww                            w
w         ww       w         wwwwwwwwwwww     wwwwwwwwwwwwww
w         w        w                                       w
w        ww        w   h     ww                            w
wwwwwwwwwwwwww  wwwwwwwwwwwwwww                            w
wwwwwwwwwwwwww  wwwwwwwwwwwwwww                  h         w
w     w      w               ww      s                     w
w     w      w     w         ww                            w
w     w      w     w         ww                            w
w     w      w     w         ww                            w
w        z   w     w                      z                w
w            w     w                                       w
w            w     wwww   wwwww                      h     w
w            w     w   h     ww                            w
w   wwwwww www     w         ww                            w
w                  w         ww                            w
wwwwwwwwwwwwwwwwwwwwwwwwwwwwwwwwwwwwwwwwwwwwwwwwwwwwwwwwwwww
